Name	title	coding
t3_jzvcjq	Biden's national security adviser pick played key role in Clinton email scandal	
t3_jyqoj0	Dr. Ben Carson: Trump Saved My Life After I Got COVID	
t3_jz5rv6	Trump campaign says Sidney Powell not a member of legal team	
t3_k04ftf	Study: Biden won thousands of illegal votes by noncitizens	
t3_k06hmi	Graham warns Biden, Pelosi and Schumer would form 'trifecta from hell' if Democrats take Senate	
t3_k089yi	'Malevolent travelers' coming if Trump's travel ban killed -- Biden has promised to eliminate executive order on 'Day 1'	
t3_jznypc	Trump campaign takes Pennsylvania election fight to federal appeals court	
t3_k0jwo5	Clyburn: 'I Wish' Bernie Sanders Would Join Biden Administration	
t3_k0ex0g	Dominion Executive: Trump is not going to win. I made f***ing sure of that.	
t3_jzmj9c	Political Enemy List Trump Accountability Project Publicly Posted on Their Website	
t3_jy6i8u	Omar suggests Biden should 'reverse' Trump's Middle East agreements, says they 'weren't peace deals'	
t3_k0jgse	Tucker Carlson Has Epic Rant About the Real Theft of the Election: "The system was rigged against one candidate" (Trump agrees)	
t3_k07qob	Patrick Buchanan: "What Trump Will Leave in Biden's Inbox"	
t3_k0ji3v	PA Rep. Guy Reschenthaler: Pa. Certifying Tainted Results 'Reckless' -- "Secretary Boockvar said Pennsylvania was going to go to Joe Biden before voting even started."	
t3_jzv44u	Trump Supporter Charged with Simple Assault for Breathing on Protesters	
t3_jzq15s	Rush Limbaugh: Trump Needs to Hold Rallies in Georgia	
t3_jztmee	Trump Responsible For Largest Rescue of American Hostages	
t3_jz0c9x	Satire: CNN Condemns Trump Rallies As 'Physically Peaceful But Morally Violent'	
t3_jz8s6s	Mail in ballots come in envelopes. They have creases. "Ga Poll Worker Describes Pristine Mail In Ballots, 98% for Biden"	
t3_k0elxb	The Fourth Estate: Andrea Mitchell reports that a Biden administration isn't going to be political	
t3_k01ja2	Alan Dershowitz Says Trump Still Has ‘Two or Three Constitutional Paths’ To A 2020 Victory – But He Hasn’t Seen The Evidence To Overturn	
t3_k0hwji	After Lecturing Trump Supporters on Masks, Jon Karl Caught Taking off His Mask Today in WH Press Briefing Room When He Thinks the Cameras Are Off	
t3_k0gw1d	Holman Jenkins: Media Hysteria Is the Trump Show	
t3_k05c36	War and more war coming with Biden’s Sec. of State Blinken	
t3_k0hdca	Trump team wins hearings in Arizona, Michigan and Pennsylvania legislatures on election concerns	
t3_jyzpvt	How Trump Responded When Liz Cheney Called on Him to Concede: "Sorry Liz, can’t accept the results of an election with hundreds of thousands of fraudulent votes cast, enough to easily flip the Election. You’re just unhappy that I’m bringing the troops back home where they belong!"	
t3_jyoerq	'Very strange': Devin Nunes says Democrats lack confidence in Biden victory	
t3_jzta4e	Trump Administration To Start Transition Process For Biden	
t3_k0gldq	President Trump won?	
t3_k0flki	Mueller Probe's Andrew Weissmann Wants Biden DOJ to Prosecute Trump	
t3_jzu5h2	The Socio-Political Legacy 0f Trump	
t3_k0jilv	White House press caught laughing at McEnany and Trump -- 'They got COVID. They lost the election'	
t3_jzt6dy	Appeals court to review Trump's Pennsylvania case -- Legal team on track with plan to reach Supreme Court	
t3_jzlu2s	All Republicans should support President Trump's legal fights -- Any who believe that buddying up to the Biden team is a symbol of unity, and better for America, have already abandoned Trump, conservatism, and America.	
t3_k0ei4s	Dan Bongino hints at potential run for president in 2024 if Larry Hogan runs and no Trump does	
t3_jyvqgz	Guilfoyle: You Can't Stop Rudy, You Can't Stop Trump	
t3_jzu0lg	Walter Mead: Biden’s Foreign-Policy Team Takes Shape	
t3_k0ccte	Trump: Voters are '100% correct' that 2020 'election was stolen' -- Jenna Ellis: 'Media chatter of Joe Biden picking his cabinet is like fantasy football'	
t3_k0eyot	Joseph Nye: "Trump deserves credit for pushing back on China's abusive trade practices, but it would have been better if we worked with our allies to isolate China. Also, his trade deal has been costly for Americans without changing the trade imbalance or addressing technological issues."	
t3_jzk5a1	A Circuit Breaker on Election Night? (...nearly 30 percent of Democrat voters think the election was stolen from Trump)	
t3_jyr204	Trump campaign files for new recount in Georgia	
t3_k082id	Biden's Pick For National Security Adviser Is A Steele Dossier Truther	
t3_jz5fzn	Federal judge dismisses Trump campaign’s Pennsylvania case	
t3_jynua5	Release: Toomey Statement on PA Federal Court Decision, Congratulates President-elect Biden | U.S. Senator Pat Toomey of Pennsylvania	
t3_k07qob	Patrick Buchanan: "What Trump Will Leave in Biden's Inbox"	
t3_jybrmo	Joe Biden's 'Vote Joe' website defaced by Turkish Hackers	
t3_jzdaid	Report: Maryland Gov. Larry Hogan, Anti-Trump Hero, Paid for Flawed Coronavirus Tests from South Korea	
t3_k0j2vo	Predicting a second Trump term, Sidney Powell says 'massive' Georgia lawsuit coming by Thanksgiving eve	
t3_jzxheo	WATCH: Poll monitor describes 4 a.m. Biden ballot dump -- 'I don't have faith in any election system after having witnessed this fraud'	
t3_k0e8yx	Poll Shows Media Censorship Cheated Voters of Vital Info, Robbed Trump of Second Term	
t3_jzjii3	Mark Levin: Letting Trump's legal efforts play out far better than 'what the Democrats are doing to our institutions'	
t3_k03aro	Study: Biden received thousands of non-citizen illegal votes in battleground states	
t3_jy6x6f	Whatever Happens In The Next Few Weeks, Brothers and Sisters, Remember This Clip, My Favorite 60 seconds of Trump: 'I am your voice'	
t3_k0e8yx	Poll Shows Media Censorship Cheated Voters of Vital Info, Robbed Trump of Second Term	
t3_jz3bhq	Pennsylvania election: Trump appeals dismissal of bid to block vote certification	
t3_k0k0z2	US should encourage China's rise, Biden national security pick Jake Sullivan says	
t3_jz8xh4	Trump campaign to appeal dismissal of election lawsuit in Pennsylvania	
t3_k0hgs2	Facts Matter: Trump's Game Plan to Win	
t3_jzqyu6	Joel Kotkin: The Green End Game Runs Through Biden	
t3_jzi8g6	Trump’s legal team’s statement on Sydney Powell was made to focus on the upcoming Supreme Court case. There are two separate legal pathways. One on equal protection and PA voting rules (most important right now). The second is Dominion software which will take longer.	
t3_jyxl1z	How to explain Latino support for Trump? ABC News reports misleading memes went viral in Latino communities	
t3_k0ja69	Biden Picks Swamper Who Falsely Accused Michael Flynn of Russian Collusion as National Security Advisor	
t3_k0gu0e	Biden’s Cabinet: The Return of the Blob	
t3_jzhbcz	The Death Star Strategy: Is Trump Contemplating The Ultimate Constitutional Trick Shot?	
t3_k0ja69	Biden Picks Swamper Who Falsely Accused Michael Flynn of Russian Collusion as National Security Advisor	
t3_jyxyyy	China Issues Instructions for ‘Incoming Biden Administration’	
t3_k04g30	NY Mag Scientifically Proves Biden Supporters Are Racist	
t3_k0hvw1	Antifa leader threatens 'armed' action against Trump supporters -- 'If you do not concede by Sunday at noon, we will begin to block roads'	
t3_jytpjk	Pa. Senator Pat Toomey Says President Trump Has 'Exhausted All Plausible Legal Options'	
t3_jzv491	Reince Priebus reacts to Wis. Dems' rule-change try following Trump recount filing: ‘You can’t make this up!'	
t3_jymov0	Trump Warns 'Massive Fraud' to Be Uncovered in Michigan Vote	
t3_k087mh	In picking John Kerry as his cabinet-level “climate czar,” Joe Biden is signaling strong support for Rep. Alexandria Ocasio-Cortez’s costly Green New Deal. Rumors are circulating that AOC is being considered for EPA administrator or elsewhere in the administration.	
t3_jzta4e	Trump Administration To Start Transition Process For Biden	
t3_k02wgo	Maxine Waters Pushes for Investigation of 'Criminal' Trump To 'Send a Message Across the World'	
t3_jzvpb2	Comment I found in a recent thread that I think that a lot of the doomer-skeptics need to read. Not necessarily saying that Trump will *totally* pull through with the evidence, but I think all you Reddit detectives should at least give him some reasonable benefit of the doubt.	
t3_jzsxow	Trump Lawyer: Michigan Legislature Agrees to Hold Election Review Hearings	
t3_jzrhs0	Biden's Treasury Secretary: Janet Yellen	
t3_jyc5wq	Bo Erickson of CBS asks Biden about his son. He says it's just a smear campaign.	
t3_k04ftf	Study: Biden won thousands of illegal votes by noncitizens	
t3_k04poa	Fearing break-up, Facebook plans to woo Joe Biden with new vaccine and climate change PR	
t3_jzpzzc	Janet Yellen Is Biden’s Pick for Treasury Secretary	
t3_k0bxsq	From revolution to restoration: Biden picks Blinken, Yellen, Kerry for plum posts	
t3_jyvpw5	BREAKING: FDA Grants Emergency Use Authorization To Antibody Cocktail Used By Trump	
t3_k05eu0	Trump lawsuit confuses Michigan and Minnesota locations in affidavit claiming voter fraud	
t3_jzv491	Reince Priebus reacts to Wis. Dems' rule-change try following Trump recount filing: ‘You can’t make this up!'	
t3_jzjptq	Two-thirds of GOP voters support Trump running for president in 2024: survey	
t3_jylbj0	CNN Condemns Trump Rallies As 'Physically Peaceful But Morally Violent'	
t3_jysprc	FDA Grants Emergency Use Authorization To Antibody Cocktail Used By Trump	
t3_k0elxb	The Fourth Estate: Andrea Mitchell reports that a Biden administration isn't going to be political	
t3_jztmee	Trump Responsible For Largest Rescue of American Hostages	
t3_k0ib41	Biden Announces He Will Immediately Move To Give Citizenships To Millions Of Illegal Aliens	
t3_jyd2rr	Watch: Sidney Powell – Millions of DEAD People Voted! 7 Million Votes STOLEN From Trump!	
t3_k0dwph	Mattis says he hopes Joe Biden takes 'America First' out of national security strategy	
t3_jzitza	Why The Left Can Be So Ridiculously Self-Righteous Without Realizing It -- What we saw in the lead up to the elections, and what we’ll witness for years to come, is utter contempt for Trump voters and conservatives in general.	
t3_jzcm4f	Report: Biden to Name Russia Hoaxer, CNN Analyst Tony Blinken Secretary of State	
t3_jzuvjc	Trump Administration Begins Transition Process	
t3_k0jq0y	Pennsylvania, Arizona, Michigan Legislatures to Hold Public Hearings on Election: Trump Campaign	
t3_jzxheo	WATCH: Poll monitor describes 4 a.m. Biden ballot dump -- 'I don't have faith in any election system after having witnessed this fraud'	
t3_k0j2vo	Predicting a second Trump term, Sidney Powell says 'massive' Georgia lawsuit coming by Thanksgiving eve	
t3_jyby0o	Trump Announces Groundbreaking Rules to Lower Prescription Drug Prices	
t3_jzrtvc	N.Y. Times op-ed admits: Trump was correct, reopen the schools	
t3_jycog9	‘Beltway Biden’ Moves the Skeletons in His Closet to the White House.	
t3_jzu0rh	Rush Limbaugh On Trump’s Legal Team: ‘They Promised Blockbuster Stuff And Then Nothing Happened’	
t3_k06k0b	Two of Joe Biden's national security picks have ties to past scandals	
t3_jzexf7	Trump’s gains in North Philly show Latino voters are not a ‘gimme’ for Democrats	
t3_jztcs5	Dems Threatened Govt Official, Her Family And Pets in Order to Obtain Govt Transition Funds for Biden	
t3_jy56dt	Trump Announces New Regulations Lowering Prescription Drug Costs	
t3_k0iurh	Biden Announces He Will Immediately Move To Give Citizenship To Millions Of Illegal Aliens	
t3_k0ei4s	Dan Bongino hints at potential run for president in 2024 if Larry Hogan runs and no Trump does	
t3_jyhsxr	Brian Williams mocks Geraldo Rivera suggestion to name COVID-19 vaccine after Trump	
t3_jydj00	LIVE: March for Trump in Atlanta, Georgia	
t3_jzv44u	Trump Supporter Charged with Simple Assault for Breathing on Protesters	
t3_jzms1q	Pro-Trump Attorney Lin Wood Urges Republicans Not To Vote In Georgia Senate Runoff -- Unless GOP candidates help overturn the presidential election results in the state.	
t3_k0ddev	Nolte: Only 3% of Trump Voters Believe Joe Biden Is Legitimate Winner	
t3_jywdz5	Philly Bans All Indoor Gatherings Unless You're Still Counting Biden Votes	
t3_k0fcyi	Poll: One In Six Biden Voters Would Have Changed Their Vote If They Had Known About Scandals Suppressed By Media	
t3_k0jpi3	Nearly a Tenth of Biden Voters in Key States Would Not Have Voted for Him Had They Known About Hunter Biden Scandal	
t3_k06hmi	Graham warns Biden, Pelosi and Schumer would form 'trifecta from hell' if Democrats take Senate	
t3_jztzoa	The mullah report: is Biden bringing back the Iran Deal? | Spectator USA	
t3_jzzay5	Trump Won't Budge From Veto Threat Over Renaming Bases Honoring Confederates	
t3_jy47z9	Biden Mocks a Reporter for Asking a Question as Biden's Staff Tries to Get the Press Out of There	
t3_jzxk30	Study: Noncitizen votes gave Biden wins in Arizona, Georgia -- 'Decimates' claim there's 'no evidence of large-scale fraud'	
t3_k084zn	FNC's Laura Ingraham: 'I Would Be Lying to You' if I Said There Was an 'Excellent' Chance SCOTUS Delivers Victory to Trump	
t3_jzicud	Here Comes the Biden Blame Game - If the double-dip recession hits next year, Biden will remind us over and over that it’s Donald Trump’s fault. He’ll be wrong.	
t3_k0dlm3	Pennsylvania, Nevada certify election results for Biden despite Trump legal challenges	
t3_jzvs4f	Trump Tells GSA, and His Team, to Begin the Transition Process; Vows to ‘Keep Up the Good Fight’	
t3_jzn4sl	Biden proposes John Poulos, CEO and President of Dominion Voting Systems, as Surgeon General and Head of Covid Analytics. Dominion will now be solely in charge of recording and keeping an exact count of what has become the most deadly virus in the history of the world.	
t3_jz7p9d	In Apparent Glitch, Voting Machines Hunt Down And Murder Trump Supporters	
t3_jzvpb2	Comment I found in a recent thread that I think that a lot of the doomer-skeptics need to read. Not necessarily saying that Trump will *totally* pull through with the evidence, but I think all you Reddit detectives should at least give him some reasonable benefit of the doubt.	
t3_k0jbio	Potential Joe Biden White House Staffer Justified Palestinian Suicide Bombers	
t3_jzrsl7	DuPont’s Shaped Biden’s "Views" (no experience!) on Business	
t3_jyl3oo	Why Joe Biden’s ‘We Just Did’ hats lack the staying power of MAGA caps	
t3_jzzay5	Trump Won't Budge From Veto Threat Over Renaming Bases Honoring Confederates	
t3_k01ja2	Alan Dershowitz Says Trump Still Has ‘Two or Three Constitutional Paths’ To A 2020 Victory – But He Hasn’t Seen The Evidence To Overturn	
t3_jytan4	Detroit voters sue President Trump over his attempt to block certification of election results	
t3_k0hukf	Remember the Warren Commission. They're back and just published the official explanation of how Joe Biden—a candidate with record low enthusiasm—flipped several swing states in the middle of the night after vote counting had been stopped. They are calling it the "Magic Ballot" theory.	
t3_jzsh0c	Trump Lawyer: Michigan Legislature Agrees to Hold Election Review Hearings	
t3_jzrc5e	Rep. Nunes Worried Biden Will Shut Down Durham Investigation	
t3_jzpdpe	Trump's election lawsuit leads to 3rd Circuit grant for expedited review	
t3_jzijpr	Trump Pulls Out Of Military Transparency Treaty With Russia, Europe	
t3_jzw2s8	Trump Tells GSA, and His Team, to Begin the Transition Process; Vows to ‘Keep Up the Good Fight’	
t3_k005l3	President Trump: "We are moving full speed ahead. Will never concede to fake ballots &amp; 'Dominion'"	
t3_k0ajsq	Joe Biden Central-Planning Ambitions Dangerous	
t3_k0b0kz	Trump vows he’ll ‘never concede’ despite administration starting transition move	
t3_jywg7k	Devout Catholic Joe Biden, our most pro-abortion president	
t3_jz7fr3	Latest: Why a Federal Judge Tossed Out One of the Trump Campaign's PA Lawsuits	
t3_k0c7j8	Chris Evans, Zach Braff Want A List Of ‘Trump Enablers’	
t3_jygwhl	Donald Trump Improved Standing With Latinos In 78 Of America’s 100 Majority-Hispanic Counties	
t3_jzmy0e	'Joe Biden is a very weak President, could start wars': Chinese government advisor | World News - Times of India	
t3_k0e90v	Secretary of state pick Antony Blinken met twice with Hunter Biden	
t3_k0flpb	Hunter Biden Arrives At White House Dressed As Turkey In Hopes Of Being Pardoned By Trump	
t3_jyfjr4	Trump Objects to Counting Thousands of Wisconsin Ballots	
t3_jyp3ti	Trump Lawyers: Pennsylvania Lawsuit Dismissal Moves Us Closer to Supreme Court	
t3_jzhhqb	Once an election has been shown dirty, all voters have been disenfranchised- "Joe Biden won illegal votes from thousands of noncitizens, study shows"	
t3_jzkxnl	Professor causes uproar asking Biden voters to unfriend him	
t3_k06k0b	Two of Joe Biden's national security picks have ties to past scandals	
t3_jy9cvg	U.S. Corporations with 'Made in China' Goods 'Optimistic' About Joe Biden	
t3_jzi0vw	5 More Ways Joe Biden Magically Outperformed Election Norms	
t3_k0jd3w	Joe Biden Manages To Tell 3 Lies at Once with Arrogant Claim	
t3_jy8kt6	Obama to produce Netflix series about Trump transition, unclear whether it will include abusing intel agencies to spy on successor	
t3_jz995u	President Trump in virtual G-20 remarks: "The Paris Accord was not designed to save the environment -- it was designed to kill the American economy."	
t3_k0ib41	Biden Announces He Will Immediately Move To Give Citizenships To Millions Of Illegal Aliens	
t3_k0j56p	FAKE NEWS: ABC, NBC Suck Up to ‘Diverse’ Biden Picks as ‘Mainstream,’ ‘Not Political’	
t3_jyhhtr	McEnany: Trump's path to victory is Supreme Court, exposing 'systemic' voter fraud	
t3_jztwv2	Revolving Door: Obama Staffers Who Joined NBC, MSNBC, and CNN, Now Headed to Biden Admin	
t3_k0k0z2	US should encourage China's rise, Biden national security pick Jake Sullivan says	
t3_k02wgo	Maxine Waters Pushes for Investigation of 'Criminal' Trump To 'Send a Message Across the World'	
t3_jz0o5f	Trump: Biden would 'kill the American economy' in rejoining climate treaty.	
t3_k0eyot	Joseph Nye: "Trump deserves credit for pushing back on China's abusive trade practices, but it would have been better if we worked with our allies to isolate China. Also, his trade deal has been costly for Americans without changing the trade imbalance or addressing technological issues."	
t3_jzuvjc	Trump Administration Begins Transition Process	
t3_jzth0n	Seven Letter Poll: 79 Percent of Trump Voters Say Election 'Stolen'	
t3_k0dlm3	Pennsylvania, Nevada certify election results for Biden despite Trump legal challenges	
t3_k0ao2g	Biden’s win in Nevada certified by Nevada Supreme Court	
t3_k080zd	FBI Buried Hunter Biden Laptop: It’s unlikely there was ever any investigation at all.	
t3_k0f9nk	Where are the Republican Politicians? Have they Deserted Trump?	
t3_jzsv52	Hunter Biden Arrives At White House Dressed As Turkey In Hopes Of Being Pardoned By Trump	
t3_jzvyov	Perdue, Loeffler Join Trump Call for New Georgia Recount	
t3_k0fhm7	The Biden Popular Front Is Doomed to Unravel	
t3_k0ccte	Trump: Voters are '100% correct' that 2020 'election was stolen' -- Jenna Ellis: 'Media chatter of Joe Biden picking his cabinet is like fantasy football'	
t3_jyn4xj	Trump campaign statement on Pennsylvania ruling	
t3_k0hgs2	Facts Matter: Trump's Game Plan to Win	
t3_k0flki	Mueller Probe's Andrew Weissmann Wants Biden DOJ to Prosecute Trump	
t3_jzvs4f	Trump Tells GSA, and His Team, to Begin the Transition Process; Vows to ‘Keep Up the Good Fight’	
t3_k05eu0	Trump lawsuit confuses Michigan and Minnesota locations in affidavit claiming voter fraud	
t3_k0iq0b	Sidney Powell: A “massive” lawsuit is coming in Georgia tomorrow that’ll save Trump’s presidency	
t3_k056dg	John Brennan's breathless &amp;amp; dramatic thread bidding farewell to the president is met with calls for Trump to 'declassify everything'	
t3_jzrh4s	Hours After Biden Picks Blinken For Secretary Of State – His Closet Door Swings Open On Iraq And Consulting	
t3_k0jilv	White House press caught laughing at McEnany and Trump -- 'They got COVID. They lost the election'	
t3_jz9jty	‘One kind of fraud’: Biden won thousands of illegal votes by noncitizens, study shows	
t3_jzx2jg	James Mattis: Joe Biden Must 'Eliminate "America First"' from U.S. Foreign Policy	
t3_jzbe4j	Orwell's 1984 is prophetic: How the leftists are trying to change and erase President Trump and history	
t3_jz421o	It begins: The Biden border surge, and too bad about the COVID lockdowns	
t3_jznr0d	Appeals Court Grants Expedited Review of Trump Campaign's Pennsylvania Lawsuit	
t3_k087mh	In picking John Kerry as his cabinet-level “climate czar,” Joe Biden is signaling strong support for Rep. Alexandria Ocasio-Cortez’s costly Green New Deal. Rumors are circulating that AOC is being considered for EPA administrator or elsewhere in the administration.	
t3_k0cbf4	Rashida Tlaib accused of anti-Semitism for reaction to Biden's Jewish Sec of State nominee	
t3_jzvyov	Perdue, Loeffler Join Trump Call for New Georgia Recount	
t3_jzq2wb	Sidney Powell responds to Trump Campaign legal statement with agreement but an “epic” lawsuit is still coming this week	
t3_jzop9w	Trump Jr. Warns Georgia Voters To Ignore Activists Encouraging Them Not To Vote In Senate Races: ‘That is NONSENSE’	
t3_jybfam	BLM, Squad members pushing Dems, Biden to abolish prison	
t3_jzverf	Trump’s Case is a Constitutional One, Sidney Powell's is a Criminal One	
t3_k0bp1y	Election Aftermath: Either Or -- It is down to an “either or” situation: either President Trump prevails in his lawsuits and multiple constitutional paths to reelection, or Joe Biden and the Democrats succeed in stealing the election.	
t3_k056dg	John Brennan's breathless &amp;amp; dramatic thread bidding farewell to the president is met with calls for Trump to 'declassify everything'	
t3_jzyvw1	Tucker Carlson: Yes, the election was rigged for Joe Biden. Here's how	
t3_jzua12	GSA notifies Joe Biden that Trump administration is ready to start transition process	
t3_jym9cn	Pennsylvania Judge Dismisses Trump Campaign's Challenge to Pennsylvania Election Law	
t3_jyulqn	Trump Team Files for Fresh Recount in Georgia’s Presidential Race	
t3_jzpd7w	JUST IN: Third Circuit Court of Appeals Grants Expedited Review For Team Trump’s Appeal in Pennsylvania	
t3_jzrh4s	Hours After Biden Picks Blinken For Secretary Of State – His Closet Door Swings Open On Iraq And Consulting	
t3_k08cy8	Trump campaign continues to fight as more evidence of voter fraud emerges	
t3_k0j56p	FAKE NEWS: ABC, NBC Suck Up to ‘Diverse’ Biden Picks as ‘Mainstream,’ ‘Not Political’	
t3_k0ioic	Financial Times: Facebook Plans to ‘Charm’ Biden by Pushing Vaccine and paris climate agreement	
t3_k0k7wi	US should encourage China's rise, Biden national security pick Jake Sullivan says	
t3_jzmvum	Appeals Court Grants Expedited Review of Trump Campaign's Pennsylvania Lawsuit	
t3_k0azmb	Computer Repair Shop Involved in Hunter Biden Laptop Scandal Shuttered	
t3_jzw2s8	Trump Tells GSA, and His Team, to Begin the Transition Process; Vows to ‘Keep Up the Good Fight’	
t3_k0azmb	Computer Repair Shop Involved in Hunter Biden Laptop Scandal Shuttered	
t3_jy4x55	Harvard Students Demand That Trump Officials Be Preemptively Barred From Campus	
t3_jycf2v	Biden Emerges from the Basement for a Few Words, but Trips Over His Own Incoherence Again	
t3_jysta7	Trump camp's lawsuit struck down in Pennsylvania	
t3_k0cwtc	Google Plots to Use the Biden Administration to Avoid Accountability	
t3_k0ao2g	Biden’s win in Nevada certified by Nevada Supreme Court	
t3_k0jpi3	Nearly a Tenth of Biden Voters in Key States Would Not Have Voted for Him Had They Known About Hunter Biden Scandal	
t3_jzrfhk	Biden &amp; Corporate Charters: A Radical, Regressive Proposal	
t3_k0gusb	EXPLOSIVE Study: Media Suppression of 8 Key Stories 'Stole This Election' for Joe Biden	
t3_jz1z44	Top House conservative plots post-Trump GOP	
t3_k07tg5	Sidney Powell responds after Trump campaign says she is not part of legal team: '#KrakenOnSteroids'	
t3_jzyv4s	Jenna Ellis insulted Trump and his supporters in 2016. The RINOs are on the inside.	
t3_jykt0d	Michigan AG Suggests Criminally Charging Republican Legislators for Meeting With Trump	
t3_k0dv2v	'WJ Live': The Viral Memo Changing the Trump Legal Strategy	
t3_k0iurh	Biden Announces He Will Immediately Move To Give Citizenship To Millions Of Illegal Aliens	
t3_jzrsl7	DuPont’s Shaped Biden’s "Views" (no experience!) on Business	
t3_k0hukf	Remember the Warren Commission. They're back and just published the official explanation of how Joe Biden—a candidate with record low enthusiasm—flipped several swing states in the middle of the night after vote counting had been stopped. They are calling it the "Magic Ballot" theory.	
t3_k0k9nr	Donald Trump on Mattis' Remarks that "America First" Policy Should Be Abandoned: "That says it all about Mattis. Obama fired him. I should have fired him sooner."	
t3_jyf2js	Biden says in video he has created 'voter fraud organization'	
t3_jyunuj	Trump campaign adviser Steve Cortes: Sudden Stop In Mail-In Vote Count 'Suspicious' -- Particularly since it was followed by a "deluge" of votes for Joe Biden in key battleground states.	
t3_jz3j9r	BLM Founders Demand Joe Biden Support A 'Roadmap' To Abolition Of Police, Prisons	
t3_jyoy6m	Biden to ‘Racist’ Trump Voters: ‘Let’s Heal.’ That’s Easy for Him to Say.	
t3_k080zd	FBI Buried Hunter Biden Laptop: It’s unlikely there was ever any investigation at all.	
t3_k084zn	FNC's Laura Ingraham: 'I Would Be Lying to You' if I Said There Was an 'Excellent' Chance SCOTUS Delivers Victory to Trump	
t3_jy8qby	Joe Biden: Why Are Reporters Asking Me Questions? On Friday, Biden appeared dumbfounded as to why a reporter was asking the projected Democratic presidential-elect a question as the press pool was being scurried away by staff.	
t3_k0jwo5	Clyburn: 'I Wish' Bernie Sanders Would Join Biden Administration	
t3_jzaqqe	An statement from Senator Toomey regarding the Pennyslvania Federal Court decision regarding the Trump campaign lawsuit.	
t3_k0flhj	Biden’s Gun-Registration Scheme Would Cost Firearm Owners Billions — If It Passed Congress and Americans Complied	
t3_k0jgse	Tucker Carlson Has Epic Rant About the Real Theft of the Election: "The system was rigged against one candidate" (Trump agrees)	
t3_k0ex0g	Dominion Executive: Trump is not going to win. I made f***ing sure of that.	
t3_jygoog	Trump voters back the President’s charges of election fraud led by Democrats	
t3_jzbqm7	Trump campaign demands recount, signature matching in Georgia	
t3_jymbgb	BLM Co-Founder Calls on Biden to Back a Crazy Progressive 'Civil Rights' Bill	
t3_jzvcjq	Biden's national security adviser pick played key role in Clinton email scandal	
t3_jybaah	Rudy and Sidney’s Krakentastic Spectacle, and What It Could Mean -- A dismissive legacy media might have panned Team Trump’s press conference Thursday, but it was a significant moment with significant portents.	
t3_jypl7c	“I’m Joe Biden and Why Am I On This Magazine?”	
t3_k04g30	NY Mag Scientifically Proves Biden Supporters Are Racist	
t3_jzntsc	GOP Former National Security Officials Urge Party to Demand Trump Concession	
t3_jznbrr	U.S. Election: Trump legal team distances itself from lawyer after controversial comments - National | Globalnews.ca	
t3_jysdc9	Body Language - Obama Advice To President Trump	
t3_jyb4tl	6 Big Claims by Trump’s Lawyers About Overturning Election Results	
t3_jzjbne	Sidney Powell Confirms Non-Affiliation With Trump Legal Team, Vows to Continue Fraud Fight	
t3_k0flhj	Biden’s Gun-Registration Scheme Would Cost Firearm Owners Billions — If It Passed Congress and Americans Complied	
t3_k005l3	President Trump: "We are moving full speed ahead. Will never concede to fake ballots &amp; 'Dominion'"	
t3_jzjgop	Open Letter Calls on Harvard to Create 'System of Accountability' for Inviting Trump Admin Alums to Campus	
t3_jzth0n	Seven Letter Poll: 79 Percent of Trump Voters Say Election 'Stolen'	
t3_jym704	Obama Appointed Federal Judge Dismisses Trump Campaign Lawsuit in Pennsylvania	
t3_k0a51f	BREAKING: New poll shows 17 percent of Biden voters would have avoided picking Biden if they knew of stories the media suppressed:	
t3_jyp309	Lockdown Addicts -- New data from Sweden show it’s safe to keep schools open, but Joe Biden’s Covid-19 advisors seem more interested in shutting down.	
t3_jztzoa	The mullah report: is Biden bringing back the Iran Deal? | Spectator USA	
t3_jzua12	GSA notifies Joe Biden that Trump administration is ready to start transition process	
t3_jylfat	Hispanic Voters In Florida Who Fled Dictatorships Think The Election Was Stolen From Trump	
t3_jz5f71	Julie Burchill: President Trump has loved and been great for Israel	
t3_jzsxow	Trump Lawyer: Michigan Legislature Agrees to Hold Election Review Hearings	
t3_k089yi	'Malevolent travelers' coming if Trump's travel ban killed -- Biden has promised to eliminate executive order on 'Day 1'	
t3_jydzd2	Twitter says it will hand control of US president's official account to Joe Biden on January 20 - regardless of whether Donald Trump has left the White House	
t3_jzqca2	Trump scores two wins as Michigan legislature, federal appeals court agree to election reviews	
t3_jz1up7	Trump Lawyer Says New Lawsuits Will Be Filed in Georgia Soon: 'Quite a Shock'	
t3_jzsv52	Hunter Biden Arrives At White House Dressed As Turkey In Hopes Of Being Pardoned By Trump	
t3_jyqh97	Chinese Warn Against Communism at Trump Rally, Tell Americans to Speak Out	
t3_k03aro	Study: Biden received thousands of non-citizen illegal votes in battleground states	
t3_jz9dqx	Lou Dobbs Warns the GOP: Republican Party ‘Will Be Gone and Done’ If They Don’t Stand With President Trump	
t3_jzaje9	Scranton dedicates 'Joe Biden Way' to honor president-elect	
t3_jzjzln	A Neighbor You Like Probably Voted For Trump	
t3_jypjqa	Merkel's Germany Tells Trump Not to Bring Troops Home from Afghanistan	
t3_jzqrab	Poll: Americans Want Biden to Stay Out of Trump Investigations &amp; Pass on Progressive Policies for Now	
t3_k0ajsq	Joe Biden Central-Planning Ambitions Dangerous	
t3_jztwv2	Revolving Door: Obama Staffers Who Joined NBC, MSNBC, and CNN, Now Headed to Biden Admin	
t3_jzjlmh	Democrat House Losses Stemmed From Trump Increasing Voter Turnout: Rep. Richmond	
t3_jyuhux	Trump campaign attorney responds to Pennsylvania ruling &amp; they’re grateful	
t3_k0ah7t	Ted Cruz Hits AOC for Criticizing Senate Recess. "AOC seems not to know there are Democrats in the Senate. Or that Joe Biden (also a Dem) is publicly calling on Senate Dems to continue filibustering COVID relief because he thinks it will help them win Georgia.”	
t3_jyobi4	Michigan Legislators Face Calls For Possible Criminal Charges After Meeting With President Trump On Certification	
t3_jyiy24	McEnany: Trump's Path To Victory Is Supreme Court, Exposing 'Systemic' Voter Fraud	
t3_k06ko7	Biden’s Student Loan Bailouts: Bad Economics, A Regressive Tax, And A Moral Hazard	
t3_jzfqzc	Do Trump-Supporters Live in an Alternate Universe? Actually a huge number of Americans have a false impression of reality because they are being told lies by their media. The people who constantly hear these lies do live in an "alternate reality."	
t3_jy6h4r	Romney on Trump election tactics: 'Difficult to imagine a worse, more undemocratic action' by president	
t3_jzxk30	Study: Noncitizen votes gave Biden wins in Arizona, Georgia -- 'Decimates' claim there's 'no evidence of large-scale fraud'	
t3_jyp7pw	Judge Dismisses Trump Campaign’s Pennsylvania Lawsuit, Slams ‘Strained’ Reasoning; This only helps these cases reach higher levels of court because signed affidavits are admissible in court	
t3_k06ko7	Biden’s Student Loan Bailouts: Bad Economics, A Regressive Tax, And A Moral Hazard	
t3_k085p9	Rubio derides Biden's foreign policy team: 'Polite and orderly caretakers of America's decline'	
t3_jygabf	Ilhan Omar Urges Biden To ‘Reverse’ President Trump’s Middle East Agreements	
t3_jzhelc	Mike Flynn Jr. adds twist to Trump team’s statement on Sidney Powell: ‘Give this the 24hr rule …’	
t3_jz37gc	Trump Derangement Syndrome in Democrats won't go away with Trump	
t3_jypb2u	Philly Bans All Indoor Gatherings Unless You're Still Counting Biden Votes	
t3_k0a51f	BREAKING: New poll shows 17 percent of Biden voters would have avoided picking Biden if they knew of stories the media suppressed:	
t3_k05c36	War and more war coming with Biden’s Sec. of State Blinken	
t3_k0k9nr	Donald Trump on Mattis' Remarks that "America First" Policy Should Be Abandoned: "That says it all about Mattis. Obama fired him. I should have fired him sooner."	
t3_k0fcyi	Poll: One In Six Biden Voters Would Have Changed Their Vote If They Had Known About Scandals Suppressed By Media	
t3_jzrhs0	Biden's Treasury Secretary: Janet Yellen	
t3_k0flpb	Hunter Biden Arrives At White House Dressed As Turkey In Hopes Of Being Pardoned By Trump	
t3_k0int3	Donald and Melania Trump heckled by reporters at Thanksgiving turkey pardon ceremony: Donald Trump and First Lady Melania were all smiles at a Thanksgiving event at the White House despite heckles from reporters	
t3_k0dwph	Mattis says he hopes Joe Biden takes 'America First' out of national security strategy	
t3_jzrfhk	Biden &amp; Corporate Charters: A Radical, Regressive Proposal	
t3_k0eqm4	After joining Burisma, Hunter Biden requested meetings with Antony Blinken, Biden's Pick for Secretary of State	
t3_k0hdca	Trump team wins hearings in Arizona, Michigan and Pennsylvania legislatures on election concerns	
t3_jzu0lg	Walter Mead: Biden’s Foreign-Policy Team Takes Shape	
t3_jyaufj	Berkeley professor sparks outrage by claiming Trump supporters who have an 'indifference' to COVID are like Germans who 'ignored and profited from the Holocaust'	
t3_jzt98m	Appeals Court Grants Expedited Review of Trump Campaign's Pennsylvania Lawsuit	
t3_jyl85p	Judge Dismisses Trump Campaign Suit to Invalidate PA Election Certification With Prejudice	
t3_k0jq0y	Pennsylvania, Arizona, Michigan Legislatures to Hold Public Hearings on Election: Trump Campaign	
t3_jzyv4s	Jenna Ellis insulted Trump and his supporters in 2016. The RINOs are on the inside.	
t3_k0gusb	EXPLOSIVE Study: Media Suppression of 8 Key Stories 'Stole This Election' for Joe Biden	
t3_jynp3x	Trump Orders Hasty Afghanistan, Iraq Drawdowns to Beat Biden Inauguration	
t3_k0eqm4	After joining Burisma, Hunter Biden requested meetings with Antony Blinken, Biden's Pick for Secretary of State	
t3_jz56nz	GOP senator says Trump to Biden transition should begin 'tomorrow morning'	
t3_k0bxsq	From revolution to restoration: Biden picks Blinken, Yellen, Kerry for plum posts	
t3_jywlfu	How Dominion Software Helped Joe Biden Rig Election Win	
t3_k0ioic	Financial Times: Facebook Plans to ‘Charm’ Biden by Pushing Vaccine and paris climate agreement	
t3_k0bp1y	Election Aftermath: Either Or -- It is down to an “either or” situation: either President Trump prevails in his lawsuits and multiple constitutional paths to reelection, or Joe Biden and the Democrats succeed in stealing the election.	
t3_k0iq0b	Sidney Powell: A “massive” lawsuit is coming in Georgia tomorrow that’ll save Trump’s presidency	
t3_jzyhtm	Biden climate envoy John Kerry is a lifelong joke	
t3_jz593p	'This Obama judge' is 'outrageous': Mark Levin blasts PA ruling dismissing Trump voter fraud challenge	
t3_k08cy8	Trump campaign continues to fight as more evidence of voter fraud emerges	
t3_jyp5q9	Actor Scott Baio threatens to move to Utah to unseat Sen. Mitt Romney after his anti-Trump tweet	
t3_k07tg5	Sidney Powell responds after Trump campaign says she is not part of legal team: '#KrakenOnSteroids'	
t3_jzo3u5	Obama's third term: Biden reveals first cabinet picks	
t3_jyv0um	FDA Grants Emergency Use Authorization To Antibody Cocktail Used By Trump	
t3_k0f9nk	Where are the Republican Politicians? Have they Deserted Trump?	
t3_jyzq16	Putin Says He’s Not Ready to Recognize Biden as U.S. President	
